NO        textures/BrickWallBlue.png
SO     textures/redBricksWall.png
WE textures/BrickWallPurple.png

EA textures/BrickWallgrey.png

C 51,153,255
F 160,160,160

11111111111111111111111111
100000000110000000000000W1
10000000011000000000000001
10000011100000110001100001
10000011100000110001100001
10000011100000000000000001
10000011100000000000000001
10000011100000000011111111
10000011100000000000000001
11100011100000000000000001
10000000000000000111100111
10000000000000000000000001
10001000000010000000000001
11111111111111111111111111
