NO        ./path_to_the_north_texture
SO     ./path_to_the_south_texture
WE ./path_to_the_west_texture

EA ./path_to_the_east_texture

C 225,30,0
F 227,100,5

11111111111111111111111111
10000000011000000000000001
10000000011000000000000001
10000011100000110001100001
10000011100000110001100001
10000011100000000000000001
10000011100000000S00000001
10000011100000000011111111
10000011100000000000000001
11100011100000000000000001
10000000000000000111100111
10000000000000000000000001
10001000000010000000000001
11111111111111111111111111