NO        textures/Bricks_01.png
SO     textures/Tile_20.png
WE textures/Tile_16.png

EA textures/chessBoard.png

C 51,153,255
F 160,160,160

11111111111111111111111111
100000000110000000000000W1
10000000011000000000000001
10000011100000110001100001
10000011100000110001100001
10000011100000000000000001
10000011100000000000000001
10000011100000000011111111
10000011100000000000000001
11100011100000000000000001
10000000000000000111100111
10000000000000000000000001
10001000000010111111111111
1001111110011111
100000000000001
100011110011111111111111
10000011000000000000010011
10000010000000000000000001
10000011000000000000010001
11101111111011111111110001
110000110000001      10001
100000010000001      10001
100000010000001      10001
10000000000000111111111011111111111
10000001000000100000000000000000001
100000010000001000000000000000000011111
110000110000001001110000000000110010001
111111111111111001000000000000010010001
              1000000000000000000010001
              1000000000000000000010001
              1000000000000000000000001
              1000000000000000000010001
              1000000000000000000010001
              1001000000000000010010001
              1001100000000000110010001
              1000000000000000000010001
              1000000000000000000010001
              1111111111111111111111111
