NO        ./path_to_the_north_texture
SO     ./path_to_the_south_texture
WE ./path_to_the_west_texture

EA ./path_to_the_east_texture

C 225,30,0
F 227,100,5

11111111111111111111111111
10000000001100000000000001
10000111110000000000000001
10000001100000000000000001
1000000110000000N000000001
10000001100000000000000001
10000001100000000011111111
10000001100000000000000001
10000001100000000000000001
10000000000000000111100111
10000000000000000000000001
10001000000010000000000001
11111111111111111111111111
