NO        textures/BrickWallBlue.png
SO     textures/redBricksWall.png
WE textures/BrickWallPurple.png

EA textures/BrickWallgrey.png

C 51,153,255
F 160,160,160

11111111111111111111
10010000000000000001
10010000000000000001
10010011000010000001
10010000000010000001
100100011000100N0001
10000000000010000001
11111111111111111111
