11111111111111111111
10010000000000000001
10010000000000000001
10010011000010000001
10010000000010000001
10010001100010000001
10000000000010000001
11111111111111111111
