NO        ./path_to_the_north_texture
SO     ./path_to_the_south_texture
WE ./path_to_the_west_texture
EA ./path_to_the_east_texture

C 225,30,0
F 227,100,5

1111111111111111111111111
100000000110000000000001
1011000001110000000000001
1001000000000000000000001
111111110111000011100000011111111
10000000001 1000001110111111111111   111111111111
1111011111 111011100000010001
1111011111 111011101010010001
110000001  110101110000010011
10000000011100001100000010001
10000000000000N01101010010001
11000001110110111110111100111
11110111 1110101 101111010001
11111111 1111111 111111111111
1111111111111111 11111111
