NO        textures/BrickWallBlue.png
SO     textures/redBricksWall.png
WE textures/BrickWallPurple.png

EA textures/BrickWallgrey.png

C 51,153,255
F 160,160,160

11111111111111111111111111
10001111001111111111111111
10000011000000000000010011
10000000000000000000000001
10000011000000000000010001
11101111111011111111110001
110000110000001      10001
100000010000001      10001
100000010000001      10001
10000000000000111111110011111111111
10000001000000100000000000000000001
100000010000001000000000000000000011111111111111111
110000110000001001110000000000110010000000000000001
111111111111111001000000000000010010000000000000001
              1000000000000000000010000000000000001
              1000000000000000000010000000000000001
              1000000000000000000000000000000000001
              1000000000000000000010000000000000001
              10000000000N0000000010000000000000001
              1000000000000000000010000000000000001
              1000000000000000000010000000000000001
              1000000000000000000010000000000000001
              1000000000000000000010000000000000001
              1111111111111111111111111111111111111
